74444444444444444444444444444446/
31111111111111111111111111111112/
31444444444444111111111111111112/
31111111111111111111111111111112/
31111111111111111111111111111112/
31111111111111111111111111111112/
31111111111111111111111111111112/
31444444444444111111111111111112/
31111111111111111111111111111112/
31111111111111111111111111111112/
31111111111111111111111111111112/
31111111111111111111111111111112/
31111111111111111144444111111112/
31111111111111111131112112431112/
31111111111111444111112444131112/
31111111111111312131111111131212/
31111144444444312144444414431112/
31111111111111111111111111111112/
31111114444444444444444441111112/
31111111111111111111111111111112/
31111111111111111111111111111112/
31111111111111111111111111111112/
31111111111111111111111111111112/
31111111111111111111111111111112/
31111111111111111111111111111112/
31111111111111111111111111111112/
31111111111111111111111111111112/
31111111111111111111111111111112/
31111111111111111111111111111112/
31111111111111111111111111111112/
31111111111111111111111111111112/
44444444444444444444444444444444/
