74444444444444444444444444444446/
31111111111111111111111111111112/
31111111111111111111111111111112/
31111111111111111111111111111112/
31111111111111111111111111111112/
31111111111111111111111111111112/
31111111111111111111111111111112/
31111111111111111111111111111112/
31111111111111111111111111111112/
31111111111111111111111111111112/
31111111111111111111111111111112/
31111111111111111111111111111112/
31111111111111111111111111111112/
31111111111111111111111111111112/
31111111111111111111111111111112/
31111111111111111111111111111112/
31111111111111111111111111111112/
31111111111111111111111111111112/
31111111111111111111111111111112/
31111111111111111111111111111112/
31111111111111111111111111111112/
31111111111111111111111111111112/
31111111111111111111111111111112/
31111111111111111111111111111112/
31111111111111111111111111111112/
31111111111111111111111111111112/
31111111111111111111111111111112/
31111111111111111111111111111112/
31111111111111111111111111111112/
31111111111111111111111111111112/
31111111111111111111111111111112/
44444444444444444444444444444444/

