7444444444444446/
3111111111111112/
3144444444444412/
3111111111111112/
3111111111111112/
3111111111111112/
3111111111111112/
3144444444444412/
3111111111111112/
4444444444444444/
