74444444444444444444444444444446/
31111111111111111111111111111112/
31444444444444111111111111111112/
31111111111111111111111111111112/
31111111111111111111111111111112/
31111111111111111111111111111112/
31111111111111111111111111111112/
31444444444444111111111111111112/
31111111111111111111111111111112/
31111111111111111111111111111112/
31111111111111111111111111111112/
31111111111111111111111111111112/
31111111111111111111111111111112/
31111111111111111111111111111112/
31111111111111444111111111111112/
31111111111111212111111111111112/
31111111111111212111111111111112/
31111111111111111111111111111112/
31111111111111111111111111111112/
31111111111111111111111111111112/
31111111111111111111111111111112/
31111111111111111111111111111112/
31111111111111111111111111111112/
31111111111111111111111111111112/
31111111111111111111111111111112/
31111111111111111111111111111112/
31111111111111111111111111111112/
31111111111111111111111111111112/
31111111111111111111111111111112/
31111111111111111111111111111112/
31111111111111111111111111111112/
44444444444444444444444444444444/
