11111111111111111/
12931299311111111/
1a008000088883111/
15b415bb41111a831/
11111111111284171/
11111111111711641/
12993111299031111/
1a0008880000c1111/
1a00c111a000c1111/
1a00c111a000c1111/
1a00c1115bbb41111/
1a0008888d1111111/
15bb4111111111111/
11111111111111111/