5333333333333333333333335
3000000000000000000000004
3000000000000000000000004
3000000000000000000000004
3000000000000000000000004
3000000000000000000000004
3000000000000000000000004
3000000000000000000000004
3000000000000000000000004
3000000000000000000000004
3000000000000000000000004
3000000000000000000000004
3000000000000000000000004
3000000000000000000000004
3000000000000000000000004
3000000000000000000000004
3000000000000000000000004
3000000000000000000000004
3000000000000000000000004
1111111111111111111111111
