00000000000000000000000000000000/
00000000000000000000000000000000/
00000000000000000000000000000000/
00000000000000000000000000000000/
00000000000000000000000000000000/
00000000000000000000000000000000/
00000000000000000000000000000000/
00000000000000000000000000000000/
00000000000000000000000000000000/
00000000000000000000000000000000/
00000000000000000000000000000000/
00000000000000000000000000000000/
00000000000000000000000000000000/
00000000000000000000000000000000/
00000000000000000000000000000000/
00000000000000000000000000000000/
00000000000000000000000000000000/
00000000000000000000000000000000/
00000000000000000000000000000000/
00000000000000000000000000000000/
00000000000000000000000000000000/
00000000000000000000000000000000/
00000000000000000000000000000000/
00000000000000000000000000000000/
00000000000000000000000000000000/
07444444444444600000000000000000/
03111111111111944444444444460000/
03111111111111111111111111120000/
03111111111111111111111111120000/
03111111111111d444444444444b0000/
0a444444444444b00000000000000000/
00000000000000000000000000000000/
