74444444444444444444444444444446/
31111111111111111111111111111112/
31111111111111111111111111111112/
31111111111111111111111111111112/
31111111111111111111111111111112/
31111111111111111111111111111112/
31111111111111111111111111111112/
31111111111111111111111111111112/
31111111111114111111111111111112/
31111111111111111111111111111112/
31111111111113111111111111111112/
31111111111111111111111111111112/
31111111111112111111111111111112/
31111111111111111111111111111112/
31111111111111111111111111111112/
31111111111117111111111111111112/
31111111111111111111111111111112/
31111111111111111111111111111112/
31111111111111111111111111111112/
31111111111111111111111111111112/
31111111111111111111111111111112/
31111111111111111111111111111112/
31111111111111111111111111111112/
31111111111111111111111111111112/
31111111111111111111111111111112/
31111111111111111111111111111112/
31111111111111111111111111111112/
31111111111111111111111111111112/
31111111111111111111111111111112/
31111111111111111111111111111112/
31111111111111111111111111111112/
44444444444444444444444444444444/

