74444460000000000000000000000000/
31111120000000000000000000000000/
31111120000074444444460000000000/
31111124444431111111120000000000/
31111111111111111111120000000000/
31111111111111111111120000000000/
31111124444431111111120000000000/
31111120000031111111120000000000/
31111120000031111111120000000000/
44444440000044444444440000000000/
00000000000000000000000000000000/
31111111111113111111111111111112/
31111111111111111111111111111112/
31111111111112111111111111111112/
31111111111111111111111111111112/
31111111111111111111111111111112/
31111111111117111111111111111112/
31111111111111111111111111111112/
31111111111111111111111111111112/
31111111111111111111111111111112/
31111111111111111111111111111112/
31111111111111111111111111111112/
31111111111111111111111111111112/
31111111111111111111111111111112/
31111111111111111111111111111112/
31111111111111111111111111111112/
31111111111111111111111111111112/
31111111111111111111111111111112/
31111111111111111111111111111112/
31111111111111111111111111111112/
31111111111111111111111111111112/
44444444444444444444444444444444/

