00000000000000007444444600000000
00744444446000003111111200000000
00311111112000003111111200000000
00311111119444448111111200000000
00311111111111111111111200000000
0031111111d4444c1111111200000000
00311111112000031111111200000000
00a4444444b000031111111200000000
00000000000000031111111944600000
00000744444444481111111111200000
00744811111111111111111111200000
00311111111111111111111111200000
0031dc11111111111111111111200000
00312a4444444444444c1d4444b00000
00312000000000000003120000000000
0031200000000000000a4b0000000000
00312000000000000000007460000000
00312000000000000746003120000000
00319444444460000312003120000000
00311111111194444819448120000000
00311111111111111111111120000000
003111111111d444444444c120000000
00311111111120000000003120000000
00a444444444b000000000a4b0000000
00000000000000000000000000000000
07444444444444600000000000000000
03111111111111944444444444460000
03111111111111111111111111120000
03111111111111111111111111120000
03111111111111d444444444444b0000
0a444444444444b00000000000000000
00000000000000000000000000000000
