74444460000000000000000000000000/
31111120000000000000000000000000/
31111120000074444444460000000000/
31111120000031111111120000000000/
31111194444481111111120000000000/
31111111111111111111120000000000/
311111d44444c1111111120007460000/
31111120000031111111120003120000/
31111120000031111111120003120000/
ac1d44b00000a44c1d444b0003120000/
03120000000000031200000003120000/
03120000000000031200000003120000/
03120000000000031200000003120000/
03194444444444481200000003120000/
03111111111111111200000003120000/
0ac1d4444444444c1200000003120000/
00312000000000031200000003120000/
00312000000000031200000003120000/
00312000000744481944444448194600/
00319444444811111111111111111200/
00311111111111111111111111111200/
0031d844444c11111111111111111200/
00312000000311111111111111111200/
00312000000a44444444c1d444444b00/
00312000000000000000312000000000/
07819444444444600000312000000000/
03111111111111944444819444460000/
03111111111111111111111111120000/
03111111111111d444444444444b0000/
03111111111111200000000000000000/
0a444444444444b00000000000000000/
00000000000000000000000000000000/
