00000000000000000000000000000000
00744444444444444444444444446000
00311111111111111111111111112000
00311111111111111111111111112000
00311111111111111111111111112000
00311111111111111111111111112000
00311111111111111111111111112000
00311111111111111111111111112000
00311111111111111111111111112000
00a44444444c11111d4444444444b000
00000000000311111200000000000000
00000000000311111200000000000000
00000000074811111946000000000000
00000000031111111112000000000000
000000000a4c11111d4b000000000000
00000000000311111200000000000000
00000000074811111946000000000000
00000000031111111112000000000000
000000000a4c11111d4b000000000000
00000000000311111200000000000000
00007444444811111200000000000000
00003111111111111200000000000000
00003111111111111200007444460000
00003111d44444444b00003111120000
000031112000000000074481d44b0000
07448111944444600003111120000000
0311111111111120000a44c120000000
03111111111111200000003120000000
03111111111111944444448120000000
03111111111111111111111120000000
0a4444444444444444444444b0000000
00000000000000000000000000000000
